1	5	512	80	0	0	0	0	420	600	0	0
2	5	610	48	0	0	0	0	580	715	0	0
3	5	1475	111	0	0	0	0	1400	1600	0	0
4	5	2082	111	0	0	0	0	1995	2220	0	0
5	5	2275	143	0	0	0	0	2240	2335	0	0
6	5	2465	143	0	0	0	0	2365	2585	0	0
7	5	2672	111	0	0	0	0	2545	2800	0	0