1	1	250	128	4	251	251	526	141	167	355	375
2	1	305	128	4	306	306	526	184	200	397	415
3	1	338	128	4	306	306	526	184	200	397	415
4	1	433	128	4	306	306	526	184	200	397	415
5	4	255	145	4	306	255	800	0	0	353	366
